###############
##########    E
########## ####
########## ####
########## ####
###        ####
### ###########
### ###########
### ###### ####
###          ##
############ ##
############ ##
############ ##
######### ## ##
##S           #