*************************************************************************
*************************************************************************
             *                 **            *            *         *   *
** ********* ************* *** **** ******** * * *** ****** **** ** * * *
** **   * ** **          * *** **     *    * * * * *      * **** ** * * *
** ** * * ** ** *********    * **** * * **** * * * * ******    * ** * * *
** ** * * ** ** ********** * * **   * *      * * *       ***** *    * * *
** ** * * ** ** **       * * * **** ********** * ******* *     ****** * *
** ** * * ** ** ** ***** * * * ** * *          *       * * ***    *   * *
** ** * *  * ** ** *   * * * * ** * * ** * *********** * ******** * *** *
** ** * ** * ** ** *** *   * * ** * * ** *    *      * *       **   *   *
**    * ** * ** **     * *** * ** * * *  * ** * **** * * ** ***** ***** *
** ** * ** * ** ** **************** * **** ** * * ** * * ** *         * *
** ** * **              *      ***  *    * ** * *    * * ** * ********* *
** ** * ******* ** *********** ****** **** *  * ****** * ** * * *       *
** ** *       * ** ******   ** **  ** ** * ****        * ** * * * ** ** *
** ** ******* * **       ** ** ***    **      ********** **   * * ** ** *
** ** ******* * ********* * ** ****** ** ********* ************ * ** ** *
** **       * *           * ** **        *    **** **         * * ** ** *
** ********** ******** ** * ** ******** ** **    * ** ******* * * ** ** *
** ** ********* ***       * ** **     *    ** ** * **       * *    * ** *
** ** *       * *** ****  * ** ****** ******* ** * ******** * * ** * ** *
** ** * ** ** * *** ** *  *    **  ** **      ** *        * * * ** * ** *
** ** * ** ** *     ** * ** ** *** ** ** **** ** * * ****** * * ** **** *
** ** *  * ** * ** *** *  * ** *** ** ** *  * ** * * ***  * * * *  *    *
** * ****** *    * *****   *** *** ** ** ** * *  * * *** ** * * *********
** * *      ****** *     ***** ****** **    * * ** *   * ** * *     *   *
** * * **** ****** ** ***           * ******* * ** * *** ** * * ***** * *
** * * *  * *    * ** ***************         * ** *        * *       * *
** * * * ** *** ** **    ********************** ** ******** * ********* *
** * * * ** *** ** *****                      *             *         * .
** * * * ** *      *   * ************************************************
** * * * ** *** **** * * ************************************************
