###S###########
##            E
## ###### #####
##  ##### #####
##  ##### #####
#   ###### ####
###        ####
###############
########## ####
##########  ###
###############
###############
###############
###############
###############