###############
S    #####   ##
# # ###### ####
# #     ## ####
# ##### ## ####
#   #   ## ####
### #      ####
### ###########
### ###### ####
### ######  ###
###       # ###
##### ##### ###
###   #########
### ###########
###E###########